11111111111111111111111111
10002000400040002000300001
10002000300040000000300101
100000003000400020000001w1
10002000300000002424242421
10p02000000040000000000001
11111111111111111111111111
